NO textures/mossy.xpm
SO textures/greystone.xpm
WE textures/eagle1701187887.xpm
EA textures/colorstone.xpm

F 165,82,45
C 135,206,235

        1111111111111111111111111
        1000000000000000000000001
        1011000000000000000000001
        1001000000000000000000001
111111111011000000000000000000001
100000000011000011111111111111111
10000000000000000000000000001
10000000000000000000000000001
10000000000000000000000000001
10000000000000000000000000001
100000000000S0000000000000001
10000000000000000000000000001
10000000000000000000000000001
10000000000000000000000000001
10000000000000000000000000001
11000001110101011111011110011
11110111 1110101 101111010001
11111111 1111111 111111111111

