NO textures/redbrick1701186336.xpm
SO textures/redbrick1701186336.xpm
WE textures/eagle1701187887.xpm
EA textures/redbrick1701186336.xpm

F 80,60,30
C 135,206,235

        1111111111111111111111111
        1000000000110000000000001
        1011000000000000000000001
        1001000000000000000000001
1111111110110000000S0000000000001
100000000011000000000111111111111
10000000000000000000000000001
10000000000000000000000000001
10000000000000000000000000001
10000000000000000000000000001
10000000000000000000000000001
10000000000000000000000000001
10000000000000000000000000001
10000000000000000000000000001
10000000000000000000000000001
110000011101010111110111100111
11110111 1110101 101111010001
11111111 1111111 111111111111
